{
    "lines": 21,
    "cols": 78,
    "minimap": [
        " ####  ###### ",
        " #          # ",
        "    ####      ",
        "   #  #   # # ",
        "    #  ##   # ",
        " #          # ",
        " ####  ###### "
    ],
    "bitmap": [
        "                                                                              ",
        "                                                                              ",
        "                                                                              ",
        "     ##########         ##############################         ##########     ",
        "     #                                                                  #     ",
        "     #                                                                  #     ",
        "     #        #############                                             #     ",
        "                                                                              ",
        "                                                                              ",
        "                          # #               #                                 ",
        "              #          #   #             #                                  ",
        "               #        #     #           #                                   ",
        "                #      #       #         #                                    ",
        "                 #    #         #       #                                     ",
        "     #            # #           ########                                #     ",
        "     #                                                                  #     ",
        "     #                                                                  #     ",
        "     ##########         ##############################         ##########     ",
        "                                                                              ",
        "                                                                              ",
        "                                                                              "
    ],
    "player_init": [
        12,
        39
    ],
    "z_entrance": {
        "up": [10],
        "left": [12],
        "down": [14],
        "right": [8]
    }
}