{
    "lines": 21,
    "cols": 78,
    "minimap": [
        " ####  #### ",
        " #   ##   # ",
        "    #  #     ",
        "    ####    ",
        "    #  #    ",
        " #        # ",
        " ####  #### "
    ],
    "bitmap": [
        "                                                                              ",
        "                                                                              ",
        "                                                                              ",
        "     ##########         ##############################         ##########     ",
        "     #                                                                  #     ",
        "     #                                                                  #     ",
        "     #                     ###         # ###########                    #     ",
        "                          #   #         #                                     ",
        "                         #     #         #                                    ",
        "                        #       #         #                                   ",
        "                       #         #         #                                  ",
        "                      #    ###    #         #                                 ",
        "                     #             #         #                                ",
        "                    #               #         #                               ",
        "     #             #                 #         #                        #     ",
        "     #                                                                  #     ",
        "     #                                                                  #     ",
        "     ##########         ##############################         ##########     ",
        "                                                                              ",
        "                                                                              ",
        "                                                                              "
    ],
    "player_init": [
        10,
        39
    ],
    "z_entrance": {
        "up": [2],
        "left": [12],
        "down": [14],
        "right": [8]
    }
}